NO ./wood.xpm
SO ./wood.xpm
WE ./wood.xpm
EA ./wood.xpm


C      147, 150, 148
F        65,     66,      65   




1111111111111111111111111111111111111
1000000000000000000000000000000000001
1000000000000000000000000000000000001
1000000000000000000000000000000000001
1000000000000000000000011121100000001
1000000000000000000000000000000000001
1000000000000000000000000000000000001
1000000000000001110000011211100000001
1000000000000001 10000000000000000001
1000000000000001110000011121110000001
1000000000000000000000000000010000001
1000000000000000000000000000020000001
1000000000000000000000000000010000001
1000000000000000N00000000000010000001
1000000000000000000000000000000000001
1000000000000000000000000000000000001
1111111111111111111111111111111111111