NO ./wood.xpm
SO ./wood.xpm
WE ./wood.xpm
EA ./wood.xpm



C      147, 150, 148
F        65,     66,      65   




11111111111111111111111111111111111111
1000000000000000000000000000000000001
1000000000000000000000000000000000001
1000000000000000000000000000000000001
1000000000000000000000000000000000001
1000000000000000000000000000000000001
1000000000000000000000000000000000001
100000000000000   0000000000000000001
1000000000000001 10000000000000000001
1000000000000001110000000000000000001
1000000000000000000000000000000000001
1000000000000000000000000000000000001
1000000000000000000000000000000000001
1000000000000000N00000000000000000001
1000000000000000000000000000000000001
1000000000000000000000000000000000001
1111111111111111111111111111111111111