NO ./wood.xpm
SO ./wood.xpm
WE ./wood.xpm
EA ./wood.xpm


C      147, 150, 148
F        65,     66,      65   




111111111111111111111111111111111111111111111111111111111111111111111111111111111111111111111111111111111111111111111111111
100000000000000000000000000000000000000000000000000000000000000000000000000000000000000000000000000000000000000000000000001
100000000000000000000000000000000000000000000000000000000000000000000000000000000000000000000000000000000000000000000000001
100000000000000000000000000000000000000000000000000000000000000000000000000000000000000000000000000000000000000000000000001
100000000000000000000000000000000000000000000000000000000000000000000000000000000000000000000000000000000000000000000000001
100000000000000000000000000000000000000000000000000000000000000000000000000000000000000000000000000000000000000000000000001
100000000000000000000000000000000000000000000000000000000000000000000000000000000000000000000000000000000000000000000000001
100000000000000000000000000000000000000000000000000000000000000000000000000000000000000000000000000000000000000000000000001
100000000000000000000000000000000000000000000000000000000000000000000000000000000000000000000000000000000000000000000000001
100000000000000000000000000000000000000000000000000000000000000000000000000000000000000000000000000000000000000000000000001
100000000000000000000000000000000000000000000000000000000000000000000000000000000000000000000000000000000000000000000000001
100000000000000000000000000000000000000000000000000000000000000000000000000000000000000000000000000000000000000000000000001
100000000000000000000000000000000000000000000000000000000000000000000000000000000000000000000000000000000000000000000000001
100000000000000000000000000000000000000000000000000000000000000000000000000000000000000000000000000000000000000000000000001
100000000000000000000000000000000000000000000000000000000000000000000000000000000000000000000000000000000000000000000000001
100000000000000000000000000000000000000000000000000000000000000000000000000000000000000000000000000000000000000000000000001
100000000000000000000000000000000000000000000001111111111111111111111111111000000000000000000000000000000000000000000000001
100000000000000000000000000000000000000000000001                          1000000000000000000000000000000000000000000000001
100000000000000000000000000000000000000000000001                          1000000000000000000000000000000000000000000000001
100000000000000000000000000000000000000000000001                          1000000000000000000000000000000000000000000000001
100000000000000000000000000000000000000000000001                          1000000000000000000000000000000000000000000000001
100000000000000000000000000000000000000000000001                          1000000000000000000000000000000000000000000000001
100000000000000000000000000000000000000000000001                          1000000000000000000000000000000000000000000000001
100000000000000000000000000000000000000000000001                          1000000000000000000000000000000000000000000000001
100000000000000000000000000000000000000000000001                          1000000000000000000000000000000000000000000000001
100000000000000000000000000000000000000000000001                          1000000000000000000000000000000000000000000000001
100000000000000000000000000000000000000000000001111111111111111111111111111000000000000000000000000000000000000000000000001
100000000000000000000000000000000000000000000000000000000000200000000000000000000000000000000000000000000000000000000000001
100000000000000000000000000000000000000000000001111111111111111111111111111000000000000000000000000000000000000000000000001
100000000000000000000000000000000000000000000001                          1000000000000000000000000000000000000000000000001
100000000000000000000000000000000000000000000001                          1000000000000000000000000000000000000000000000001
100000000000000000000000000000000000000000000001                          1000000000000000000000000000000000000000000000001
100000000000000000000000000000000000000000000001                          1000000000000000000000000000000000000000000000001
100000000000000000000000000000000000000000000001                          1000000000000000000000000000000000000000000000001
100000000000000000000000000000000000000000000001                          1000000000000000000000000000000000000000000000001
100000000000000000000000000000000000000000000001                          1000000000000000000000000000000000000000000000001
100000000000000000000000000000000000000000000001                          1000000000000000000000000000000000000000000000001
100000000000000000000000000000000000000000000001                          1000000000000000000000000000000000000000000000001
100000000000000000000000000000000000000000000001                          1000000000000000000000000000000000000000000000001
100000000000000000000000000000000000000000000001                          1000000000000000000000000000000000000000000000001
100000000000000000000000000000000000000000000001111111111111111111111111111000000000000000000000000000000000000000000000001
100000000000000000000000000000000000000000000000000000000000000000000000000000000000000000000000000000000000000000000000001
100000000000000000000000000000000000000000000000000000000000000000000000000000000000000000000000000000000000000000000000001
100000000000000222222222222222222222222222222222222222222222222222222222222222222222222222222222222222222220000000000000001
100000000000000222222222222222222222222222222222222222222222222222222222222222222222222222222222222222222220000000000000001
100000000000000222222222222222222222222222222222222222222222222222222222222222222222222222222222222222222220000000000000001
100000000000000222222222222222222222222222222222222222222222222222222222222222222222222222222222222222222220000000000000001
100000000000000222222222222222222222222222222222222222222222222222222222222222222222222222222222222222222220000000000000001
100000000000000222222222222222222222222222222222222222222222222222222222222222222222222222222222222222222220000000000000001
100000000000000222222222222222222222222222222222222222222222222222222222222222222222222222222222222222222220000000000000001
100000000000000222222222222222222222222222222222222222222222222222222222222222222222222222222222222222222220000000000000001
100000000000000222222222222222222222222222222222222222222222222222222222222222222222222222222222222222222220000000000000001
100000000000000222222222222222222222222222222222222222222222222222222222222222222222222222222222222222222220000000000000001
100000000000000222222222222222222222222222222222222222222222222222222222222222222222222222222222222222222220000000000000001
100000000000000222222222222222222222222222222222222222222222222222222222222222222222222222222222222222222220000000000000001
100000000000000222222222222222222222222222222222222222222222222222222222222222222222222222222222222222222220000000000000001
100000000000000222222222222222222222222222222222222222222222222222222222222222222222222222222222222222222220000000000000001
100000000000000222222222222222222222222222222222222222222222222222222222222222222222222222222222222222222220000000000000001
100000000000000222222222222222222222222222222222222222222222222222222222222222222222222222222222222222222220000000000000001
100000000000000222222222222222222222222222222222222222222222222222222222222222222222222222222222222222222220000000000000001
100000000000000222222222222222222222222222222222222222222222222222222222222222222222222222222222222222222220000000000000001
100000000000000222222222222222222222222222222222222222222222222222222222222222222222222222222222222222222220000000000000001
100000000000000222222222222222222222222222222222222222222222222222222222222222222222222222222222222222222220000000000000001
100000000000000222222222222222222222222222222222222222222222222222222222222222222222222222222222222222222220000000000000001
100000000000000222222222222222222222222222222222222222222222222222222222222222222222222222222222222222222220000000000000001
100000000000000222222222222222222222222222222222222222222222222222222222222222222222222222222222222222222220000000000000001
100000000000000222222222222222222222222222222222222222222222222222222222222222222222222222222222222222222220000000000000001
100000000000000222222222222222222222222222222222222222222222222222222222222222222222222222222222222222222220000000000000001
100000000000000222222222222222222222222222222222222222222222222222222222222222222222222222222222222222222220000000000000001
100000000000000222222222222222222222222222222222222222222222222222222222222222222222222222222222222222222220000000000000001
100000000000000222222222222222222222222222222222222222222222222222222222222222222222222222222222222222222220000000000000001
100000000000000222222222222222222222222222222222222222222222222222222222222222222222222222222222222222222220000000000000001
100000000000000222222222222222222222222222222222222222222222222222222222222222222222222222222222222222222220000000000000001
100000000000000222222222222222222222222222222222222222222222222222222222222222222222222222222222222222222220000000000000001
100000000000000222222222222222222222222222222222222222222222222222222222222222222222222222222222222222222220000000000000001
100000000000000222222222222222222222222222222222222222222222222222222222222222222222222222222222222222222220000000000000001
100000000000000222222222222222222222222222222222222222222222222222222222222222222222222222222222222222222220000000000000001
100000000000000222222222222222222222222222222222222222222222222222222222222222222222222222222222222222222220000000000000001
100000000000000222222222222222222222222222222222222222222222222222222222222222222222222222222222222222222220000000000000001
100000000000000000000000000000000000000000000000000000000000000000000000000000000000000000000000000000000000000000000000001
100000000000000000000000000000000000000000000000000000000000000000000000000000000000000000000000000000000000000000000000001
100000000000000000000000000000000000000000000000000000000000000000000000000000000000000000000000000000000000000000000000001
100000000000000000000000000000000000000000000000000000000000000000000000000000000000000000000000000000000000000000000000001
100000000000000000000000000000000000000000000000000000000000000000000000000000000000000000000000000000000000000000000000001
100000000000000000000000000000000000000000000000000000000000000000000000000000000000000000000000000000000000000000000000001
100000000000000000000000000000000000000000000000000000000000000000000000000000000000000000000000000000000000000000000000001
100000000000000000000000000000000000000000000000000000000000000000000000000000000000000000000000000000000000000000000000001
100000000000000000000000000000000000000000000000000000000000000000000000000000000000000000000000000000000000000000000000001
100000000000000000000000000000000000000000000000000000000000000000000000000000000000000000000000000000000000000000000000001
100000000000000000000000000000000000000000000000000000000000000000000000000000000000000000000000000000000000000000000000001
100000000000000000000000000000000000000000000000000000000000000000000000000000000000000000000000000000000000000000000000001
100000000000000000000000000000000000000000000000000000000000000000000000000000000000000000000000000000000000000000000000001
100000000000000000000000000000000000000000000000000000000000000000000000000000000000000000000000000000000000000000000000001
100000000000000000000000000000000000000000000000000000000000000000000000000000000000000000000000000000000000000000000000001
100000000000000000000000000000000000000000000000000000000000000000000000000000000000000000000000000000000000000000000000001
100000000000000000000000000000000000000000000000000000000000000000000000000000000000000000000000000000000000000000000000001
100000000000000000000000000000000000000000000000000000000000000000000000000000000000000000000000000000000000000000000000001
100000000000000000000000000000000000000000000000000000000000000000000000000000000000000000000000000000000000000000000000001
100000000000000000000000000000000000000000000000000000000000000000000000000000000000000000000000000000000000000000000000001
100000000000000000000000000000000000000000000000000000000000000000000000000000000000000000000000000000000000000000000000001
100000000000000000000000000000000000000000000000000000000000000000000000000000000000000000000000000000000000000000000000001
100000000000000000000000000000000000000000000000000000000000000000000000000000000000000000000000000000000000000000000000001
100000000000000000000000000000000000000000000000000000000000000000000000000000000000000000000000000000000000000000000000001
100000000000000000000000000000000000000000000000000000000000000000000000000000000000000000000000000000000000000000000000001
100000000000000000000000000000000000000000000000000000000000000000000000000000000000000000000000000000000000000000000000001
100000000000000000000000000000000000000000000000000000000000000000000000000000000000000000000000000000000000000000000000001
100000000000000000000000000000000000000000000000000000000000000000000000000000000000000000000000000000000000000000000000001
100000000000000000000000000000000000000000000000000000000000000000000000000000000000000000000000000000000000000000000000001
100000000000000000000000000000000000000000000000000000000000000000000000000000000000000000000000000000000000000000000000001
100000000000000000000000000000000000000000000000000000000000000000000000000000000000000000000000000000000000000000000000001
100000000000000000000000000000000000000000000000000000000000000000000000000000000000000000000000000000000000000000000000001
100000000000000000000000000000000000000000000000000000000000000000000000000000000000000000000000000000000000000000000000001
100000000000000000000000000000000000000000000000000000000000000000000000000000000000000000000000000000000000000000000000001
100000000000000000000000000000000000000000000000000000000000000000000000000000000000000000000000000000000000000000000000001
100000000000000000000000000000000000000000000000000000000000000000000000000000000000000000000000000000000000000000000000001
100000000000000000000000000000000000000000000000000000000000000000000000000000000000000000000000000000000000000000000000001
100000000000000000000000000000000000000000000000000000000000000000000000000000000000000000000000000000000000000000000000001
100000000000000000000000000000000000000000000000000000000000000000000000000000000000000000000000000000000000000000000000001
100000000000000000000000000000000000000000000000000000000000000000000000000000000000000000000000000000000000000000000000001
100000000000000000000000000000000000000000000000000000000000000000000000000000000000000000000000000000000000000000000000001
100000000000000000000000000000000000000000000000000000000000000000000000000000000000000000000000000000000000000000000000001
100000000000000000000000000000000000000000000000000000000000000000000000000000000000000000000000000000000000000000000000001
100000000000000000000000000000000000000000000000000000000000000000000000000000000000000000000000000000000000000000000000001
100000000000000000000000000000000000000000000000000000000000000000000000000000000000000000000000000000000000000000000000001
100000000000000000000000000000000000000000000000000000000000000000000000000000000000000000000000000000000000000000000000001
100000000000000000000000000000000000000000000000000000000000000000000000000000000000000000000000000000000000000000000000001
100000000000000000000000000000000000000000000000000000000000000000000000000000000000000000000000000000000000000000000000001
100000000000000000000000000000000000000000000000000000000000000000000000000000000000000000000000000000000000000000000000001
100000000000000000000000000000000000000000000000000000000000000000000000000000000000000000000000000000000000000000000000001
100000000000000000000000000000000000000000000000000000000000000000000000000000000000000000000000000000000000000000000000001
100000000000000000000000000000000000000000000000000000000000000000000000000000000000000000000000000000000000000000000000001
100000000000000000000000000000000000000000000000000000000000000000000000000000000000000000000000000000000000000000000000001
100000000000000000000000000000000000000000000000000000000000000000000000000000000000000000000000000000000000000000000000001
100000000000000000000000000000000000000000000000000000000000000000000000000000000000000000000000000000000000000000000000001
100000000000000000000000000000000000000000000000000000000000000000000000000000000000000000000000000000000000000000000000001
100000000000000000000000000000000000000000000000000000000000000000000000000000000000000000000000000000000000000000000000001
100000000000000000000000000000000000000000000000000000000000000000000000000000000000000000000000000000000000000000000000001
100000000000000000000000000000000000000000000000000000000000000000000000000000000000000000000000000000000000000000000000001
100000000000000000000000000000000000000000000000000000000000000000000000000000000000000000000000000000000000000000000000001
100000000000000000000000000000000000000000000000000000000000000000000000000000000000000000000000000000000000000000000000001
100000000000000000000000000000000000000000000000000000000N00000000000000000000000000000000000000000000000000000000000000001
100000000000000000000000000000000000000000000000000000000000000000000000000000000000000000000000000000000000000000000000001
100000000000000000000000000000000000000000000000000000000000000000000000000000000000000000000000000000000000000000000000001
100000000000000000000000000000000000000000000000000000000000000000000000000000000000000000000000000000000000000000000000001
100000000000000000000000000000000000000000000000000000000000000000000000000000000000000000000000000000000000000000000000001
111111111111111111111111111111111111111111111111111111111111111111111111111111111111111111111111111111111111111111111111111