NO ./textures/wood.xpm
SO ./textures/wood.xpm
WE ./textures/wood.xpm
EA ./textures/wood.xpm



C      147, 150, 148
F        65,     66,      65   




1111111111111111111111111111111111111
1000000000000000000000000000000000001
1000000000000000000000000000000000001
1000000000000000000000000000000000001
1000000000000000000000000000000000001
1000000000000000000000000000000000001
1000000000000000000000000000000000001
1000000000000001110000000000000000001
1000000000000001 10000000000000000001
1000000000000001110000000000000000001
1000000000000000000000000000000000001
1000000000000000000000000000000000001
1000000000000000000000000000000000001
1000000000000000N00000000000000000001
1000000000000000000000000000000000001
1000000000000000000000000000000000001
1111111111111111001111111111111111111