NO ./textures/wood.xpm
SO ./textures/wood.xpm
WE ./textures/wood.xpm
EA ./textures/wood.xpm


C      147, 150, 148
F        65,     66,      65   




1111111111111111    111111111111
1000000000000001    100000000001
1000000000000001    100000000001
1000000000000001    100000000001
1000000000000001    100000000001
1000000000000001    100000000001
1000000000000001    100000000001
1000000000000001    100000000001
1000000000000001    100000000001
1000000000000001    100000000001
1000000000000001    100000000001
1001111111111001    100000000001
1001        1001    100000000001
1001        1001    100000000001
1001        1001    100000000001
1001        1001    100000000001
1001    1   1001    100000000001
1001        1001    100000000001
1001111111111001    100000000001
1000000000000001    100000000001
1000000000000001    100000000001
1000000N00000001    100002000001
1000000000000001    100000000001
1000000000000001    100000000001
1000000000000001    100000000001
1111111111111111    111111111111